
CommandType     Name                                               Version    So
                                                                              ur
                                                                              ce
-----------     ----                                               -------    --
Alias           ? -> Where-Object                                             
Alias           % -> ForEach-Object                                           
Alias           cd -> Set-Location                                            
Alias           chdir -> Set-Location                                         
Alias           clc -> Clear-Content                                          
Alias           clhy -> Clear-History                                         
Alias           cli -> Clear-Item                                             
Alias           clp -> Clear-ItemProperty                                     
Alias           cls -> Clear-Host                                             
Alias           clv -> Clear-Variable                                         
Alias           copy -> Copy-Item                                             
Alias           cpi -> Copy-Item                                              
Alias           cvpa -> Convert-Path                                          
Alias           dbp -> Disable-PSBreakpoint                                   
Alias           del -> Remove-Item                                            
Alias           dir -> Get-ChildItem                                          
Alias           ebp -> Enable-PSBreakpoint                                    
Alias           echo -> Write-Output                                          
Alias           epal -> Export-Alias                                          
Alias           epcsv -> Export-Csv                                           
Alias           erase -> Remove-Item                                          
Alias           etsn -> Enter-PSSession                                       
Alias           exsn -> Exit-PSSession                                        
Alias           fc -> Format-Custom                                           
Alias           fhx -> Format-Hex                                  7.0.0.0    M…
Alias           fl -> Format-List                                             
Alias           foreach -> ForEach-Object                                     
Alias           ft -> Format-Table                                            
Alias           fw -> Format-Wide                                             
Alias           gal -> Get-Alias                                              
Alias           gbp -> Get-PSBreakpoint                                       
Alias           gc -> Get-Content                                             
Alias           gcb -> Get-Clipboard                               7.0.0.0    M…
Alias           gci -> Get-ChildItem                                          
Alias           gcm -> Get-Command                                            
Alias           gcs -> Get-PSCallStack                                        
Alias           gdr -> Get-PSDrive                                            
Alias           gerr -> Get-Error                                             
Alias           ghy -> Get-History                                            
Alias           gi -> Get-Item                                                
Alias           gjb -> Get-Job                                                
Alias           gl -> Get-Location                                            
Alias           gm -> Get-Member                                              
Alias           gmo -> Get-Module                                             
Alias           gp -> Get-ItemProperty                                        
Alias           gps -> Get-Process                                            
Alias           gpv -> Get-ItemPropertyValue                                  
Alias           group -> Group-Object                                         
Alias           gsn -> Get-PSSession                                          
Alias           gtz -> Get-TimeZone                                7.0.0.0    M…
Alias           gu -> Get-Unique                                              
Alias           gv -> Get-Variable                                            
Alias           h -> Get-History                                              
Alias           history -> Get-History                                        
Alias           icm -> Invoke-Command                                         
Alias           iex -> Invoke-Expression                                      
Alias           ihy -> Invoke-History                                         
Alias           ii -> Invoke-Item                                             
Alias           ipal -> Import-Alias                                          
Alias           ipcsv -> Import-Csv                                           
Alias           ipmo -> Import-Module                                         
Alias           irm -> Invoke-RestMethod                                      
Alias           iwr -> Invoke-WebRequest                                      
Alias           md -> mkdir                                                   
Alias           measure -> Measure-Object                                     
Alias           mi -> Move-Item                                               
Alias           move -> Move-Item                                             
Alias           mp -> Move-ItemProperty                                       
Alias           nal -> New-Alias                                              
Alias           ndr -> New-PSDrive                                            
Alias           ni -> New-Item                                                
Alias           nmo -> New-Module                                             
Alias           nsn -> New-PSSession                                          
Alias           nv -> New-Variable                                            
Alias           oh -> Out-Host                                                
Alias           popd -> Pop-Location                                          
Alias           pushd -> Push-Location                                        
Alias           pwd -> Get-Location                                           
Alias           r -> Invoke-History                                           
Alias           rbp -> Remove-PSBreakpoint                                    
Alias           rcjb -> Receive-Job                                           
Alias           rcsn -> Receive-PSSession                                     
Alias           rd -> Remove-Item                                             
Alias           rdr -> Remove-PSDrive                                         
Alias           ren -> Rename-Item                                            
Alias           ri -> Remove-Item                                             
Alias           rjb -> Remove-Job                                             
Alias           rmo -> Remove-Module                                          
Alias           rni -> Rename-Item                                            
Alias           rnp -> Rename-ItemProperty                                    
Alias           rp -> Remove-ItemProperty                                     
Alias           rsn -> Remove-PSSession                                       
Alias           rv -> Remove-Variable                                         
Alias           rvpa -> Resolve-Path                                          
Alias           sajb -> Start-Job                                             
Alias           sal -> Set-Alias                                              
Alias           saps -> Start-Process                                         
Alias           sbp -> Set-PSBreakpoint                                       
Alias           scb -> Set-Clipboard                               7.0.0.0    M…
Alias           select -> Select-Object                                       
Alias           set -> Set-Variable                                           
Alias           si -> Set-Item                                                
Alias           sl -> Set-Location                                            
Alias           sls -> Select-String                                          
Alias           sp -> Set-ItemProperty                                        
Alias           spjb -> Stop-Job                                              
Alias           spps -> Stop-Process                                          
Alias           sv -> Set-Variable                                            
Alias           type -> Get-Content                                           
Alias           where -> Where-Object                                         
Alias           wjb -> Wait-Job                                               

